NO assets/vwall1.xpm
SO assets/vwall1.xpm
EA assets/vwall1.xpm
WE assets/vwall1.xpm
C 30,211,217
F 220,100,0
        1111111111111111111111111
        1111111111111111111111111
 
        111111111111111111111111
        1000000000110000000000001
        1011000001110000000000001
        1001000000000000000000001                 1
11111111101100000111000000000E001                101
100000000011000001110111111111111                 1
11110111111111011100000010001
11110111111111011101010010001
11000000110101011111100010001
1000000000000000111 100010001
10000000000000001101010010001
110000011101010111110111100111
11110111 1110101 101111010001
11111111 1111111 111111111111