NO assets/wall.xpm
SO assets/wall.xpm
EA assets/wall.xpm
WE assets/wall.xpm
D assets/wall.xpm
C 184,184,184
F 220,100,0

111111
100001
10N111111
100001
11111