NO assets/vwall1.xpm
SO assets/vwall1.xpm
EA assets/vwall1.xpm
WE assets/vwall1.xpm
C 184,184,184
F 220,100,0

      1     1     1
     101   101   101
    1001  1001  1001
   1001  1001  1001
  10011100001100001
  10000000000000001
 10000000000000001
10000000N00000001
 10000000000000001
  10000110000110001
   1001  1001  1001
    1001  1001  1001
     101   101   101
      1     1     1